type octile
height 10
width 5
map
.....
.@...
.@...
.@...
.@...
.@...
.@...
.@...
.@@@.
.....
